10 10
0 0
9 9
L-_|_-||L-
|L_-|_--_L
|-_-|_L--|
|L-L|-L|L|
L__L-__L-_
L|-||__L-L
L_--L__||-
L-_||--L_|
--_||__|_|
L__LLL____
